11111111111111111111111111111111
10000000100001001000100010000001
100P0000000001000C00000000010011
100C0000000000000000100100100001
11111111111100C001111111001000E1
11111111111111111111111111111111